60 30
############################################################
#             #                                            #
#             #                                            #
#         ########                                         #
#                #                                         #
#         #      #                                         #
#         #      #                                         #
#         ###  ###                                         #
#         #      #                                         #
#         #      #                                         #
#         #      #                                         #
###########      ###########   ###                         #
#                                #                         #
#                                #                         #
#                                #                         #
#                                ###########################
##################################                         #
#                                                          #
#                                                          #
#                                                          #
#                                                          #
#                                                          #
#                                                          #
#                                                          #
#                                                          #
#                                                          #
#                                                          #
#                                                          #
############################################################;